1;1;1;1;1;1;1;1;1;1;1;1
1;1;0;0;0;0;0;0;0;1;1;1
1;1;0;0;0;0;0;0;0;1;1;1
1;1;0;0;0;0;0;0;0;1;1;1
1;1;0;3;3;0;0;4;0;1;1;1
1;1;0;8;0;0;0;5;0;1;1;1
1;1;0;8;0;0;6;6;6;1;1;1
1;1;0;0;0;0;0;7;0;1;1;1
1;0;0;1;0;0;0;8;0;1;1;1
1;0;1;1;0;0;0;0;0;1;1;1
1;0;1;1;0;0;0;0;0;1;1;1
1;0;1;1;0;0;0;0;0;0;0;1
1;0;1;0;0;1;1;0;1;1;0;1
1;0;0;0;0;0;0;0;0;0;0;1
1;1;0;0;0;1;0;0;0;0;1;1
1;1;0;0;0;0;0;0;1;1;1;1
1;1;1;0;0;0;0;1;1;1;1;1
1;1;1;0;0;1;0;1;1;1;1;1
1;1;1;0;0;1;0;1;1;1;1;1
1;1;1;0;0;1;0;1;1;1;1;1
1;1;1;0;0;1;0;1;1;1;1;1
1;1;1;0;0;1;0;1;1;1;1;1
1;1;0;0;0;0;0;1;1;1;1;1
1;1;1;1;1;1;1;1;1;1;1;1
1;1;1;1;1;1;1;1;1;1;1;1
1;1;1;1;1;1;1;1;1;1;1;1
1;1;1;1;1;1;1;1;1;1;1;1
1;1;1;1;1;1;1;1;1;1;1;1
