1;1;1;1;1;1;1;1;1;1;1;1
1;1;1;1;0;0;0;0;0;0;0;1
1;1;1;1;0;0;0;0;0;0;0;1
1;1;0;0;0;0;0;0;0;0;0;1
1;0;0;0;0;0;4;4;0;0;0;1
1;0;0;0;8;0;6;5;0;0;0;1
1;0;0;0;0;0;7;0;0;0;0;1
1;0;0;0;0;0;0;0;0;0;0;1
1;0;0;0;0;0;0;0;0;0;0;1
1;1;1;1;1;1;1;1;1;1;1;1
